*E*******
*       *
*   *** *
* * *** *
*   *   *
**  S * *
*       *
*********